TTTTTTTTTTTTTTTTTTTT
T                T T
T R  TTTTTTTT    P T
T    T       T     T
T P  TTT P TTT     T
T       T          T
T   P   TTTTTT  P  T
T       T      R   T
T                P T
TTTTTTTTTTTTTTTTTTTT